{
  "startX": 1.5,
  "startY": 1.5,
  "startAngle": 0.0,
  "textureVariant": 0,
  "tiles": [
    [1,1,1,1,1,1,1,1,1,1,1,1,1,1,1,1,1,1,1,1],
    [1,0,0,0,0,0,0,0,0,0,0,0,0,0,0,0,0,0,0,1],
    [1,0,2,0,0,0,0,0,0,1,1,0,0,0,0,0,0,2,0,1],
    [1,0,0,0,0,0,0,0,0,1,1,0,0,0,0,0,0,0,0,1],
    [1,0,0,0,1,1,0,0,0,0,0,0,0,0,1,1,0,0,0,1],
    [1,0,0,0,1,0,0,0,0,0,0,0,0,0,0,1,0,0,0,1],
    [1,0,0,0,0,0,0,0,0,0,0,0,0,0,0,0,0,0,0,1],
    [1,0,0,0,0,0,0,3,3,3,3,3,3,0,0,0,0,0,0,1],
    [1,0,0,0,0,0,0,3,0,0,0,0,3,0,0,0,0,0,0,1],
    [1,0,1,1,0,0,0,3,0,0,0,0,3,0,0,0,1,1,0,1],
    [1,0,1,1,0,0,0,3,0,0,0,0,3,0,0,0,1,1,0,1],
    [1,0,0,0,0,0,0,3,0,0,0,0,3,0,0,0,0,0,0,1],
    [1,0,0,0,0,0,0,3,3,3,3,3,3,0,0,0,0,0,0,1],
    [1,0,0,0,0,0,0,0,0,0,0,0,0,0,0,0,0,0,0,1],
    [1,0,0,0,1,0,0,0,0,0,0,0,0,0,0,1,0,0,0,1],
    [1,0,0,0,1,1,0,0,0,0,0,0,0,0,1,1,0,0,0,1],
    [1,0,0,0,0,0,0,0,0,1,1,0,0,0,0,0,0,0,0,1],
    [1,0,2,0,0,0,0,0,0,1,1,0,0,0,0,0,0,2,0,1],
    [1,0,0,0,0,0,0,0,0,0,0,0,0,0,0,0,0,0,0,1],
    [1,1,1,1,1,1,1,1,1,1,1,1,1,1,1,1,1,1,9,1]
  ],
  "enemySpawns": [[6,1,0],[1,8,5],[9,11,6],[1,18,5],[18,5,6],[18,18,1]],
  "torchPositions": [[9,1],[1,9],[18,9],[9,18],[4,4],[15,4]]
}
