{
  "startX": 1.5,
  "startY": 1.5,
  "startAngle": 0.0,
  "textureVariant": 0,
  "tiles": [
    [1,1,1,1,1,1,1,1,1,1,1,1,1,1,1,1,1,1,1,1],
    [1,0,0,0,0,0,0,0,0,1,1,0,0,0,0,0,0,0,0,1],
    [1,0,3,0,3,0,3,0,0,1,1,0,0,3,0,0,0,3,0,1],
    [1,0,0,0,0,0,0,0,0,0,0,0,0,0,0,0,0,0,0,1],
    [1,0,0,0,2,2,0,0,0,1,1,0,0,0,2,2,0,0,0,1],
    [1,0,3,0,2,0,0,0,0,1,1,0,0,0,2,0,0,3,0,1],
    [1,0,0,0,0,0,0,0,0,1,1,0,0,0,0,0,0,0,0,1],
    [1,0,0,0,0,0,0,0,0,1,1,0,0,0,0,0,0,0,0,1],
    [1,0,0,0,0,0,0,0,0,0,0,0,0,0,0,0,0,0,0,1],
    [1,1,1,1,1,0,1,1,1,1,1,1,1,1,0,1,1,1,1,1],
    [1,1,1,1,1,0,1,1,1,1,1,1,1,1,0,1,1,1,1,1],
    [1,0,0,0,0,0,0,0,0,0,0,0,0,0,0,0,0,0,0,1],
    [1,0,0,0,0,0,0,0,0,1,1,0,0,0,0,0,0,0,0,1],
    [1,0,3,0,2,0,0,0,0,1,1,0,0,0,2,0,0,3,0,1],
    [1,0,0,0,2,2,0,0,0,1,1,0,0,0,2,2,0,0,0,1],
    [1,0,0,0,0,0,0,0,0,0,0,0,0,0,0,0,0,0,0,1],
    [1,0,3,0,0,0,3,0,0,1,1,0,0,3,0,0,0,3,0,1],
    [1,0,0,0,0,0,0,0,0,1,1,0,0,0,0,0,0,0,0,1],
    [1,0,0,0,0,0,0,0,0,0,0,0,0,0,0,0,0,0,0,1],
    [1,1,1,1,1,1,1,1,1,1,1,1,1,1,1,1,1,1,9,1]
  ],
  "enemySpawns": [[7,4,0],[3,7,1],[16,7,2],[11,16,3]],
  "torchPositions": [[4,1],[14,1],[1,4],[18,4],[1,15],[18,15]]
}
