{
  "startX": 1.5,
  "startY": 1.5,
  "startAngle": 0,
  "textureVariant": 0,
  "tiles": [
    [1,1,1,1,1,1,1,1,1,1,1,1,1,1,1,1],
    [1,0,0,0,0,0,0,0,0,0,0,0,0,0,0,1],
    [1,0,2,2,0,0,0,2,2,0,0,0,2,0,0,1],
    [1,0,2,0,0,0,0,0,2,0,0,0,2,0,0,1],
    [1,0,0,0,0,1,0,0,0,0,0,0,0,0,0,1],
    [1,0,0,0,0,1,0,0,0,0,3,3,0,0,0,1],
    [1,0,2,0,0,0,0,0,0,0,0,3,0,0,0,1],
    [1,0,2,2,0,0,0,0,0,0,0,0,0,2,0,1],
    [1,0,0,0,0,0,1,0,0,0,0,0,0,2,0,1],
    [1,0,0,0,0,0,1,1,0,0,0,0,0,0,0,1],
    [1,0,2,0,0,0,0,0,0,3,0,0,0,0,0,1],
    [1,0,2,0,0,0,0,0,0,3,0,0,2,0,0,1],
    [1,0,0,0,0,1,1,0,0,0,0,0,2,0,0,1],
    [1,0,0,0,0,0,1,0,0,0,0,0,0,0,0,1],
    [1,0,0,0,0,0,0,0,0,0,0,0,0,0,0,1],
    [1,1,1,1,1,1,1,9,1,1,1,1,1,1,1,1]
  ],
  "enemySpawns": [
    [11,11,6],
    [7,4,6],
    [7,8,1],
    [3,11,5],
    [11,2,5]
  ],
  "torchPositions": []
}