{
  "startX": 1.5,
  "startY": 1.5,
  "startAngle": 0.0,
  "textureVariant": 1,
  "tiles": [
    [1,1,1,1,1,1,1,1,1,1,1,1,1,1,1,1,1,1,1,1,1,1,1,1],
    [1,0,0,0,0,0,0,0,0,0,0,0,0,0,0,0,0,0,0,0,0,0,0,1],
    [1,0,3,0,3,0,3,0,0,0,0,0,0,0,0,0,3,0,3,0,3,0,0,1],
    [1,0,0,0,0,0,0,0,0,0,0,0,0,0,0,0,0,0,0,0,0,0,0,1],
    [1,0,0,2,0,2,0,0,0,1,1,1,1,1,0,0,0,2,0,2,0,0,0,1],
    [1,0,0,2,0,0,0,0,0,1,0,0,0,1,0,0,0,0,0,2,0,0,0,1],
    [1,0,0,0,0,0,0,0,0,1,0,0,0,1,0,0,0,0,0,0,0,0,0,1],
    [1,0,0,0,0,0,0,0,0,1,0,0,0,1,0,0,0,0,0,0,0,0,0,1],
    [1,1,0,1,0,0,0,0,0,1,1,1,1,1,0,0,0,0,0,0,1,0,1,1],
    [1,0,0,0,0,0,0,0,0,0,0,0,0,0,0,0,0,0,0,0,0,0,0,1],
    [1,0,0,0,2,0,0,0,0,0,0,0,0,0,0,0,0,0,2,0,0,0,0,1],
    [1,0,0,0,2,0,0,0,0,0,3,3,3,0,0,0,0,0,2,0,0,0,0,1],
    [1,0,0,0,0,0,0,0,0,0,3,0,3,0,0,0,0,0,0,0,0,0,0,1],
    [1,0,0,0,0,0,0,0,0,0,3,3,3,0,0,0,0,0,0,0,0,0,0,1],
    [1,1,0,1,0,0,0,0,0,0,0,0,0,0,0,0,0,0,0,0,1,0,1,1],
    [1,0,0,0,0,0,0,0,0,1,1,1,1,1,0,0,0,0,0,0,0,0,0,1],
    [1,0,0,0,0,0,0,0,0,1,0,0,0,1,0,0,0,0,0,0,0,0,0,1],
    [1,0,0,2,0,0,0,0,0,1,0,0,0,1,0,0,0,0,0,2,0,0,0,1],
    [1,0,0,2,0,2,0,0,0,1,0,0,0,1,0,0,0,2,0,2,0,0,0,1],
    [1,0,0,0,0,0,0,0,0,1,1,1,1,1,0,0,0,0,0,0,0,0,0,1],
    [1,0,3,0,3,0,3,0,0,0,0,0,0,0,0,0,3,0,3,0,3,0,0,1],
    [1,0,0,0,0,0,0,0,0,0,0,0,0,0,0,0,0,0,0,0,0,0,0,1],
    [1,0,0,0,0,0,0,0,0,0,0,0,0,0,0,0,0,0,0,0,0,0,0,1],
    [1,1,1,1,1,1,1,1,1,1,1,1,1,1,1,1,1,1,1,1,1,1,9,1]
  ],
  "enemySpawns": [[2,10,0],[10,1,5],[14,7,6],[6,16,5],[12,14,6],[18,1,5],[1,20,6],[22,7,1],[9,22,2],[20,15,3],[22,22,4]],
  "torchPositions": [[6,1],[17,1],[1,8],[22,8],[1,14],[22,14]]
}
