{
  "startX": 1.5,
  "startY": 1.5,
  "startAngle": 0.0,
  "textureVariant": 1,
  "tiles": [
    [1,1,1,1,1,1,1,1,1,1,1,1,1,1,1,1,1,1,1,1,1,1],
    [1,0,0,0,0,0,0,0,0,0,0,0,0,0,0,0,0,0,0,0,0,1],
    [1,0,3,3,0,0,0,0,0,0,0,0,0,0,0,0,0,0,3,3,0,1],
    [1,0,3,0,0,0,0,0,0,0,0,0,0,0,0,0,0,0,0,3,0,1],
    [1,0,0,0,0,0,2,2,0,0,0,0,0,0,2,2,0,0,0,0,0,1],
    [1,0,0,0,0,0,2,0,0,0,0,0,0,0,0,2,0,0,0,0,0,1],
    [1,0,0,0,0,0,0,0,0,0,0,0,0,0,0,0,0,0,0,0,0,1],
    [1,1,1,0,1,0,0,0,0,0,0,0,0,0,0,0,0,1,0,1,1,1],
    [1,0,0,0,0,0,0,0,1,1,0,0,1,1,0,0,0,0,0,0,0,1],
    [1,0,0,0,0,0,0,0,1,0,0,0,0,1,0,0,0,0,0,0,0,1],
    [1,0,0,0,2,0,0,0,0,0,0,0,0,0,0,0,2,0,0,0,0,1],
    [1,0,0,0,2,0,0,0,0,0,0,0,0,0,0,0,2,0,0,0,0,1],
    [1,0,0,0,0,0,0,0,1,0,0,0,0,1,0,0,0,0,0,0,0,1],
    [1,0,0,0,0,0,0,0,1,1,0,0,1,1,0,0,0,0,0,0,0,1],
    [1,1,1,0,1,0,0,0,0,0,0,0,0,0,0,0,0,1,0,1,1,1],
    [1,0,0,0,0,0,0,0,0,0,0,0,0,0,0,0,0,0,0,0,0,1],
    [1,0,0,0,0,0,2,0,0,0,0,0,0,0,0,2,0,0,0,0,0,1],
    [1,0,0,0,0,0,2,2,0,0,0,0,0,0,2,2,0,0,0,0,0,1],
    [1,0,3,0,0,0,0,0,0,0,0,0,0,0,0,0,0,0,0,3,0,1],
    [1,0,3,3,0,0,0,0,0,0,0,0,0,0,0,0,0,0,3,3,0,1],
    [1,0,0,0,0,0,0,0,0,0,0,0,0,0,0,0,0,0,0,0,0,1],
    [1,1,1,1,1,1,1,1,1,1,1,1,1,1,1,1,1,1,1,1,9,1]
  ],
  "enemySpawns": [[10,2,0],[5,5,1],[16,5,2],[10,10,3],[5,17,4],[16,17,5]],
  "torchPositions": [[5,1],[16,1],[1,7],[20,7],[1,14],[20,14]]
}
