{
  "startX": 1.5,
  "startY": 1.5,
  "startAngle": 0,
  "textureVariant": 0,
  "tiles": [
    [1,1,1,1,1,1,1,1,1,1,1,1,1,1,1,1],
    [1,0,0,0,0,0,0,0,0,0,0,0,0,0,0,1],
    [1,0,2,2,0,0,0,2,2,0,0,0,2,0,0,1],
    [1,0,2,0,0,0,0,0,2,0,0,0,2,0,0,1],
    [1,0,0,0,0,1,0,0,0,0,0,0,0,0,0,1],
    [1,0,0,0,0,1,0,0,0,0,3,3,0,0,0,1],
    [1,0,2,0,0,0,0,0,0,0,0,3,0,0,0,1],
    [1,0,2,2,0,0,0,0,0,0,0,0,0,2,0,1],
    [1,0,0,0,0,0,1,0,0,0,0,0,0,2,0,1],
    [1,0,0,0,0,0,1,1,0,0,0,0,0,0,0,1],
    [1,0,2,0,0,0,0,0,0,3,0,0,0,0,0,1],
    [1,0,2,0,0,0,0,0,0,3,0,0,2,0,0,1],
    [1,0,0,0,0,1,1,0,0,0,0,0,2,0,0,1],
    [1,0,0,0,0,0,1,0,0,0,0,0,0,0,0,1],
    [1,0,0,0,0,0,0,0,0,0,0,0,0,0,0,1],
    [1,1,1,1,1,1,1,9,1,1,1,1,1,1,1,1]
  ],
  "enemySpawns": [
    [7,7,0],
    [13,3,1],
    [3,10,2],
    [10,12,3],
    [14,8,4]
  ],
  "torchPositions": [
    [5,1],
    [10,1],
    [1,7],
    [14,7],
    [1,13],
    [14,13]
  ]
}