{
  "startX": 1.5,
  "startY": 1.5,
  "startAngle": 0.0,
  "textureVariant": 0,
  "tiles": [
    [1,1,1,1,1,1,1,1,1,1,1,1,1,1,1,1,1,1,1,1,1,1],
    [1,0,0,0,0,1,0,0,0,0,0,0,0,0,0,0,1,0,0,0,0,1],
    [1,0,2,0,0,1,0,0,2,0,0,0,0,2,0,0,1,0,2,0,0,1],
    [1,0,0,0,0,0,0,0,0,0,0,0,0,0,0,0,0,0,0,0,0,1],
    [1,0,0,1,1,1,0,0,0,0,1,1,0,0,0,0,1,1,1,0,0,1],
    [1,0,0,1,0,0,0,0,0,0,0,1,0,0,0,0,0,0,1,0,0,1],
    [1,0,0,1,0,0,0,3,0,0,0,0,0,0,3,0,0,0,1,0,0,1],
    [1,0,0,0,0,0,0,3,0,0,0,0,0,0,3,0,0,0,0,0,0,1],
    [1,1,0,1,0,0,0,0,0,0,0,0,0,0,0,0,0,0,1,0,1,1],
    [1,0,0,0,0,0,0,0,0,2,2,2,2,0,0,0,0,0,0,0,0,1],
    [1,0,0,0,0,0,0,0,0,2,0,0,2,0,0,0,0,0,0,0,0,1],
    [1,0,0,0,0,0,0,0,0,2,0,0,2,0,0,0,0,0,0,0,0,1],
    [1,0,0,0,0,0,0,0,0,2,2,2,2,0,0,0,0,0,0,0,0,1],
    [1,1,0,1,0,0,0,3,0,0,0,0,0,0,3,0,0,0,1,0,1,1],
    [1,0,0,0,0,0,0,3,0,0,0,0,0,0,3,0,0,0,0,0,0,1],
    [1,0,0,1,0,0,0,0,0,0,0,1,0,0,0,0,0,0,1,0,0,1],
    [1,0,0,1,1,1,0,0,0,0,1,1,0,0,0,0,1,1,1,0,0,1],
    [1,0,0,0,0,0,0,0,0,0,0,0,0,0,0,0,0,0,0,0,0,1],
    [1,0,2,0,0,1,0,0,2,0,0,0,0,2,0,0,1,0,2,0,0,1],
    [1,0,0,0,0,1,0,0,0,0,0,0,0,0,0,0,1,0,0,0,0,1],
    [1,0,0,0,0,0,0,0,0,0,0,0,0,0,0,0,0,0,0,0,0,1],
    [1,1,1,1,1,1,1,1,1,1,1,1,1,1,1,1,1,1,1,1,9,1]
  ],
  "enemySpawns": [[3,10,0],[10,1,5],[11,13,6],[17,1,5],[1,18,6],[20,7,5],[8,20,1],[20,20,2]],
  "torchPositions": [[5,1],[16,1],[1,8],[20,8],[1,13],[20,13]]
}
