{
  "startX": 1.5,
  "startY": 1.5,
  "startAngle": 0.0,
  "textureVariant": 1,
  "tiles": [
    [1,1,1,1,1,1,1,1,1,1,1,1,1,1,1,1,1,1],
    [1,0,0,0,0,0,0,1,0,0,0,0,1,0,0,0,0,1],
    [1,0,3,0,3,0,0,0,0,0,0,0,0,0,3,0,0,1],
    [1,0,0,0,0,0,0,1,0,0,0,0,1,0,0,0,0,1],
    [1,0,0,0,0,2,2,0,0,0,0,0,0,0,0,0,0,1],
    [1,1,0,1,0,0,0,0,0,0,0,0,0,0,0,1,0,1],
    [1,0,0,0,0,0,0,0,2,2,2,0,0,0,0,0,0,1],
    [1,0,0,0,0,0,0,0,2,0,2,0,0,0,0,0,0,1],
    [1,0,0,0,0,0,0,0,2,2,2,0,0,0,0,0,0,1],
    [1,0,0,0,2,0,0,0,0,0,0,0,0,0,2,0,0,1],
    [1,0,0,0,2,0,0,0,0,0,0,0,0,0,2,0,0,1],
    [1,1,0,1,0,0,0,0,0,0,0,0,0,0,0,1,0,1],
    [1,0,0,0,0,0,0,2,2,0,2,2,0,0,0,0,0,1],
    [1,0,3,0,0,0,0,0,0,0,0,0,0,0,3,0,0,1],
    [1,0,0,0,0,0,0,1,0,0,0,0,1,0,0,0,0,1],
    [1,0,0,0,0,2,2,0,0,0,0,0,0,0,0,0,0,1],
    [1,0,0,0,0,0,0,1,0,0,0,0,1,0,0,0,0,1],
    [1,1,1,1,1,1,1,1,1,1,1,1,1,1,1,1,9,1]
  ],
  "enemySpawns": [[5,2,0],[11,3,1],[9,5,2],[3,9,3],[13,10,4],[5,13,0],[11,14,1]],
  "torchPositions": [[7,1],[1,5],[16,6],[1,11],[16,12],[7,16]]
}
